{
    "2019": {
        "1": {
            "1": 13,
            "2": 1676,
            "3": 1569,
            "4": 1488,
            "5": 1630,
            "6": 1658,
            "7": 1443,
            "8": 1700,
            "9": 1120,
            "10": 1227,
            "11": 1301,
            "12": 1665,
            "13": 1721,
            "14": 1091,
            "15": 1150,
            "16": 1361,
            "17": 1098,
            "18": 1197,
            "19": 1765,
            "20": 1685,
            "21": 1113,
            "22": 1116,
            "23": 1099,
            "24": 1171,
            "25": 1222,
            "26": 1528,
            "27": 1508,
            "28": 1081,
            "29": 1078,
            "30": 1120,
            "31": 1103
        },
        "2": {
            "1": 1245,
            "2": 1747,
            "3": 1528,
            "4": 997,
            "5": 1267,
            "6": 1098,
            "7": 1188,
            "8": 1345,
            "9": 1817,
            "10": 1839,
            "11": 1102,
            "12": 1215,
            "13": 1283,
            "14": 1214,
            "15": 1379,
            "16": 1775,
            "17": 1617,
            "18": 1190,
            "19": 1412,
            "20": 1345,
            "21": 1448,
            "22": 1741,
            "23": 1847,
            "24": 1464,
            "25": 1119,
            "26": 1184,
            "27": 1119,
            "28": 1257
        },
        "3": {
            "1": 1315,
            "2": 2129,
            "3": 1762,
            "4": 1226,
            "5": 1417,
            "6": 1688,
            "7": 2103,
            "8": 2329,
            "9": 2012,
            "10": 1697,
            "11": 1029,
            "12": 1140,
            "13": 1102,
            "14": 1260,
            "15": 1192,
            "16": 1828,
            "17": 1597,
            "18": 1080,
            "19": 990,
            "20": 1226,
            "21": 1082,
            "22": 1302,
            "23": 1794,
            "24": 1568,
            "25": 1208,
            "26": 1209,
            "27": 1143,
            "28": 1120,
            "29": 1260,
            "30": 1945,
            "31": 1752
        },
        "4": {
            "1": 1100,
            "2": 1278,
            "3": 1257,
            "4": 1204,
            "5": 1243,
            "6": 1757,
            "7": 1763,
            "8": 1159,
            "9": 1167,
            "10": 1209,
            "11": 1320,
            "12": 1154,
            "13": 1570,
            "14": 1415,
            "15": 1299,
            "16": 1268,
            "17": 1186,
            "18": 1161,
            "19": 1434,
            "20": 1543,
            "21": 1702,
            "22": 1259,
            "23": 1172,
            "24": 1191,
            "25": 1097,
            "26": 1232,
            "27": 1509,
            "28": 1479,
            "29": 1330,
            "30": 1672
        },
        "5": {
            "1": 1593,
            "2": 1567,
            "3": 1507,
            "4": 1550,
            "5": 1578,
            "6": 1373,
            "7": 1418,
            "8": 1405,
            "9": 1243,
            "10": 1585,
            "11": 1629,
            "12": 1693,
            "13": 1391,
            "14": 1429,
            "15": 1265,
            "16": 1460,
            "17": 1564,
            "18": 1945,
            "19": 1922,
            "20": 1506,
            "21": 1419,
            "22": 1471,
            "23": 1388,
            "24": 1479,
            "25": 1882,
            "26": 1671,
            "27": 1640,
            "28": 1474,
            "29": 1429,
            "30": 1334,
            "31": 1612
        },
        "6": {
            "1": 1759,
            "2": 1779,
            "3": 1563,
            "4": 1527,
            "5": 1452,
            "6": 1419,
            "7": 1373,
            "8": 1534,
            "9": 1631,
            "10": 1442,
            "11": 1503,
            "12": 1818,
            "13": 1502,
            "14": 1467,
            "15": 1710,
            "16": 1733,
            "17": 1546,
            "18": 1477,
            "19": 1324,
            "20": 1344,
            "21": 1405,
            "22": 1440,
            "23": 1560,
            "24": 1423,
            "25": 1383,
            "26": 1291,
            "27": 1243,
            "28": 1362,
            "29": 1449,
            "30": 1883
        },
        "7": {
            "1": 1526,
            "2": 1412,
            "3": 1610,
            "4": 1442,
            "5": 1379,
            "6": 1786,
            "7": 1937,
            "8": 1409,
            "9": 1231,
            "10": 1508,
            "11": 1400,
            "12": 1603,
            "13": 1699,
            "14": 1549,
            "15": 1330,
            "16": 1178,
            "17": 1224,
            "18": 1420,
            "19": 1474,
            "20": 1645,
            "21": 1574,
            "22": 1434,
            "23": 1280,
            "24": 1289,
            "25": 1379,
            "26": 1348,
            "27": 1394,
            "28": 1487,
            "29": 1472,
            "30": 1466,
            "31": 1340
        },
        "8": {
            "1": 1421,
            "2": 1471,
            "3": 1784,
            "4": 1769,
            "5": 1333,
            "6": 1387,
            "7": 1353,
            "8": 1425,
            "9": 1276,
            "10": 1613,
            "11": 1966,
            "12": 1407,
            "13": 1486,
            "14": 1570,
            "15": 1700,
            "16": 1422,
            "17": 1626,
            "18": 1727,
            "19": 1491,
            "20": 1435,
            "21": 1574,
            "22": 1547,
            "23": 1637,
            "24": 1826,
            "25": 2025,
            "26": 1783,
            "27": 1688,
            "28": 1803,
            "29": 1688,
            "30": 1968,
            "31": 2146
        },
        "9": {
            "1": 2597,
            "2": 2617,
            "3": 2025,
            "4": 1761,
            "5": 1726,
            "6": 1685,
            "7": 2030,
            "8": 2134,
            "9": 1590,
            "10": 654,
            "11": 1444,
            "12": 1433,
            "13": 1389,
            "14": 2088,
            "15": 2112,
            "16": 1511,
            "17": 1392,
            "18": 1385,
            "19": 1474,
            "20": 1554,
            "21": 2082,
            "22": 2169,
            "23": 1413,
            "24": 1335,
            "25": 1331,
            "26": 1479,
            "27": 1444,
            "28": 1884,
            "29": 1585,
            "30": 1408
        },
        "10": {
            "1": 1157,
            "2": 1147,
            "3": 1176,
            "4": 1184,
            "5": 1628,
            "6": 1330,
            "7": 1223,
            "8": 991,
            "9": 837,
            "10": 891,
            "11": 1094,
            "12": 1196,
            "13": 1290,
            "14": 968,
            "15": 1122,
            "16": 1168,
            "17": 1112,
            "18": 1151,
            "19": 1605,
            "20": 1488,
            "21": 1063,
            "22": 1050,
            "23": 972,
            "24": 1016,
            "25": 1170,
            "26": 1616,
            "27": 1582,
            "28": 1112,
            "29": 1024,
            "30": 1104,
            "31": 1068
        },
        "11": {
            "1": 1171,
            "2": 1650,
            "3": 1348,
            "4": 1584,
            "5": 923,
            "6": 901,
            "7": 1077,
            "8": 1194,
            "9": 1658,
            "10": 1505,
            "11": 1146,
            "12": 1079,
            "13": 998,
            "14": 1020,
            "15": 1058,
            "16": 1609,
            "17": 1505,
            "18": 1157,
            "19": 1019,
            "20": 1105,
            "21": 1098,
            "22": 822,
            "23": 1573,
            "24": 1411,
            "25": 1049,
            "26": 1022,
            "27": 1080,
            "28": 1065,
            "29": 1402,
            "30": 1644
        },
        "12": {
            "1": 1715,
            "2": 973,
            "3": 1091,
            "4": 1083,
            "5": 987,
            "6": 1108,
            "7": 1530,
            "8": 1456,
            "9": 957,
            "10": 902,
            "11": 970,
            "12": 979,
            "13": 1411,
            "14": 1650,
            "15": 1273,
            "16": 999,
            "17": 1048,
            "18": 893,
            "19": 1132,
            "20": 1307,
            "21": 1918,
            "22": 1863,
            "23": 1258,
            "24": 1322,
            "25": 1404,
            "26": 1505,
            "27": 1660,
            "28": 2337,
            "29": 2378,
            "30": 2391,
            "31": 1684
        }
    }
}