{
    "2019": {
        "1": {
            "1": 9,
            "2": 2558,
            "3": 2210,
            "4": 2132,
            "5": 2191,
            "6": 2273,
            "7": 2039,
            "8": 2189,
            "9": 1527,
            "10": 1494,
            "11": 1678,
            "12": 2148,
            "13": 2130,
            "14": 1354,
            "15": 1338,
            "16": 1654,
            "17": 1440,
            "18": 1531,
            "19": 2324,
            "20": 2130,
            "21": 1308,
            "22": 1353,
            "23": 1341,
            "24": 1396,
            "25": 1699,
            "26": 1967,
            "27": 1919,
            "28": 1400,
            "29": 1359,
            "30": 1282,
            "31": 1427
        },
        "2": {
            "1": 1442,
            "2": 2105,
            "3": 2063,
            "4": 1155,
            "5": 1441,
            "6": 1280,
            "7": 1382,
            "8": 1661,
            "9": 2356,
            "10": 2290,
            "11": 1454,
            "12": 1580,
            "13": 1779,
            "14": 1893,
            "15": 1754,
            "16": 2484,
            "17": 2462,
            "18": 1721,
            "19": 1797,
            "20": 1782,
            "21": 2105,
            "22": 2711,
            "23": 2980,
            "24": 2230,
            "25": 1363,
            "26": 1562,
            "27": 1505,
            "28": 1653
        },
        "3": {
            "1": 1934,
            "2": 3108,
            "3": 2702,
            "4": 1822,
            "5": 2025,
            "6": 2752,
            "7": 3809,
            "8": 4197,
            "9": 3331,
            "10": 2627,
            "11": 1406,
            "12": 1507,
            "13": 1446,
            "14": 1639,
            "15": 1707,
            "16": 2710,
            "17": 2351,
            "18": 1528,
            "19": 1315,
            "20": 1618,
            "21": 1411,
            "22": 1590,
            "23": 2585,
            "24": 2179,
            "25": 1493,
            "26": 1569,
            "27": 1531,
            "28": 1577,
            "29": 1730,
            "30": 2726,
            "31": 2751
        },
        "4": {
            "1": 1372,
            "2": 1539,
            "3": 1634,
            "4": 1688,
            "5": 1685,
            "6": 2539,
            "7": 2711,
            "8": 1591,
            "9": 1784,
            "10": 1627,
            "11": 1877,
            "12": 1732,
            "13": 2454,
            "14": 2119,
            "15": 1630,
            "16": 1685,
            "17": 1578,
            "18": 1582,
            "19": 1927,
            "20": 2296,
            "21": 2581,
            "22": 1642,
            "23": 1545,
            "24": 1630,
            "25": 1489,
            "26": 1728,
            "27": 2200,
            "28": 2200,
            "29": 1696,
            "30": 1850
        },
        "5": {
            "1": 1864,
            "2": 1865,
            "3": 1744,
            "4": 1738,
            "5": 1941,
            "6": 1515,
            "7": 1656,
            "8": 1702,
            "9": 1589,
            "10": 2002,
            "11": 1907,
            "12": 1991,
            "13": 1451,
            "14": 1595,
            "15": 1566,
            "16": 1712,
            "17": 1775,
            "18": 2305,
            "19": 2285,
            "20": 1613,
            "21": 1695,
            "22": 1872,
            "23": 1806,
            "24": 2100,
            "25": 2389,
            "26": 2413,
            "27": 1948,
            "28": 1733,
            "29": 1748,
            "30": 1596,
            "31": 1823
        },
        "6": {
            "1": 2108,
            "2": 2170,
            "3": 1693,
            "4": 1852,
            "5": 1737,
            "6": 1770,
            "7": 1818,
            "8": 2012,
            "9": 2156,
            "10": 1790,
            "11": 1699,
            "12": 2337,
            "13": 1661,
            "14": 1686,
            "15": 2036,
            "16": 2170,
            "17": 1760,
            "18": 1724,
            "19": 1580,
            "20": 1621,
            "21": 1783,
            "22": 1863,
            "23": 2015,
            "24": 1549,
            "25": 1564,
            "26": 1490,
            "27": 1490,
            "28": 1537,
            "29": 1880,
            "30": 2262
        },
        "7": {
            "1": 1641,
            "2": 1693,
            "3": 1831,
            "4": 1699,
            "5": 1616,
            "6": 2086,
            "7": 2423,
            "8": 1606,
            "9": 1491,
            "10": 1746,
            "11": 1611,
            "12": 1852,
            "13": 1961,
            "14": 1964,
            "15": 1458,
            "16": 1411,
            "17": 1629,
            "18": 1767,
            "19": 1730,
            "20": 2099,
            "21": 1961,
            "22": 1600,
            "23": 1529,
            "24": 1539,
            "25": 1672,
            "26": 1639,
            "27": 1689,
            "28": 1856,
            "29": 1611,
            "30": 1674,
            "31": 1588
        },
        "8": {
            "1": 1598,
            "2": 1773,
            "3": 2171,
            "4": 2092,
            "5": 1638,
            "6": 1639,
            "7": 1611,
            "8": 1631,
            "9": 1538,
            "10": 2081,
            "11": 2375,
            "12": 1644,
            "13": 1762,
            "14": 1827,
            "15": 2079,
            "16": 1940,
            "17": 2140,
            "18": 2250,
            "19": 1693,
            "20": 1602,
            "21": 1775,
            "22": 1797,
            "23": 1865,
            "24": 2114,
            "25": 2371,
            "26": 1966,
            "27": 1789,
            "28": 1988,
            "29": 1837,
            "30": 2075,
            "31": 2252
        },
        "9": {
            "1": 2728,
            "2": 2147,
            "3": 1796,
            "4": 1756,
            "5": 1729,
            "6": 1804,
            "7": 2162,
            "8": 2298,
            "9": 1565,
            "10": 1104,
            "11": 1623,
            "12": 1491,
            "13": 1682,
            "14": 2539,
            "15": 2529,
            "16": 1733,
            "17": 1555,
            "18": 1639,
            "19": 1766,
            "20": 1880,
            "21": 2706,
            "22": 2695,
            "23": 1716,
            "24": 1563,
            "25": 1634,
            "26": 1639,
            "27": 1717,
            "28": 2238,
            "29": 2213,
            "30": 1560
        },
        "10": {
            "1": 1455,
            "2": 1534,
            "3": 1586,
            "4": 1627,
            "5": 2325,
            "6": 2109,
            "7": 1665,
            "8": 1509,
            "9": 1333,
            "10": 1440,
            "11": 1573,
            "12": 1917,
            "13": 2053,
            "14": 1271,
            "15": 1450,
            "16": 1582,
            "17": 1517,
            "18": 1627,
            "19": 2264,
            "20": 2193,
            "21": 1453,
            "22": 1417,
            "23": 1314,
            "24": 1403,
            "25": 1802,
            "26": 2370,
            "27": 2182,
            "28": 1478,
            "29": 1500,
            "30": 1610,
            "31": 1558
        },
        "11": {
            "1": 1788,
            "2": 2409,
            "3": 2109,
            "4": 2235,
            "5": 1259,
            "6": 1389,
            "7": 1575,
            "8": 1702,
            "9": 2412,
            "10": 2320,
            "11": 1630,
            "12": 1341,
            "13": 1434,
            "14": 1514,
            "15": 1682,
            "16": 2395,
            "17": 2277,
            "18": 1536,
            "19": 1461,
            "20": 1780,
            "21": 1784,
            "22": 1642,
            "23": 2702,
            "24": 2598,
            "25": 1550,
            "26": 1665,
            "27": 1705,
            "28": 1679,
            "29": 2222,
            "30": 2832
        },
        "12": {
            "1": 2799,
            "2": 1421,
            "3": 1444,
            "4": 1479,
            "5": 1443,
            "6": 1582,
            "7": 2400,
            "8": 2278,
            "9": 1398,
            "10": 1315,
            "11": 1473,
            "12": 1494,
            "13": 2005,
            "14": 2824,
            "15": 2372,
            "16": 1519,
            "17": 1719,
            "18": 1547,
            "19": 2001,
            "20": 2200,
            "21": 3169,
            "22": 3301,
            "23": 2078,
            "24": 2239,
            "25": 2533,
            "26": 2772,
            "27": 2766,
            "28": 4153,
            "29": 4555,
            "30": 4481,
            "31": 3512
        }
    }
}