{
    "2019": {
        "1": {
            "1": 4100,
            "2": 7217,
            "3": 6881,
            "4": 6905,
            "5": 6987,
            "6": 7298,
            "7": 6641,
            "8": 6608,
            "9": 5473,
            "10": 5533,
            "11": 6128,
            "12": 7330,
            "13": 6806,
            "14": 5165,
            "15": 5462,
            "16": 5493,
            "17": 5523,
            "18": 6120,
            "19": 7533,
            "20": 6730,
            "21": 5168,
            "22": 5266,
            "23": 5123,
            "24": 5336,
            "25": 6117,
            "26": 6710,
            "27": 6224,
            "28": 5229,
            "29": 5041,
            "30": 5267,
            "31": 5287
        },
        "2": {
            "1": 5781,
            "2": 7187,
            "3": 6533,
            "4": 4959,
            "5": 5359,
            "6": 5246,
            "7": 5389,
            "8": 6286,
            "9": 7634,
            "10": 6902,
            "11": 5282,
            "12": 5350,
            "13": 5585,
            "14": 6136,
            "15": 6130,
            "16": 7816,
            "17": 7291,
            "18": 5607,
            "19": 6017,
            "20": 5642,
            "21": 6242,
            "22": 7201,
            "23": 8052,
            "24": 6537,
            "25": 5155,
            "26": 5234,
            "27": 5412,
            "28": 5613
        },
        "3": {
            "1": 6458,
            "2": 8376,
            "3": 6926,
            "4": 5788,
            "5": 6123,
            "6": 7285,
            "7": 9336,
            "8": 10433,
            "9": 8308,
            "10": 7053,
            "11": 5239,
            "12": 5199,
            "13": 5215,
            "14": 5663,
            "15": 5966,
            "16": 7825,
            "17": 6692,
            "18": 5213,
            "19": 4855,
            "20": 5420,
            "21": 5235,
            "22": 5681,
            "23": 7476,
            "24": 6477,
            "25": 5509,
            "26": 5499,
            "27": 5395,
            "28": 5387,
            "29": 6087,
            "30": 7669,
            "31": 7418
        },
        "4": {
            "1": 5000,
            "2": 5368,
            "3": 5386,
            "4": 5484,
            "5": 6090,
            "6": 7275,
            "7": 7188,
            "8": 5419,
            "9": 5710,
            "10": 5598,
            "11": 5926,
            "12": 5921,
            "13": 7342,
            "14": 6500,
            "15": 5658,
            "16": 5628,
            "17": 5366,
            "18": 5473,
            "19": 6663,
            "20": 7144,
            "21": 7418,
            "22": 5652,
            "23": 5765,
            "24": 5571,
            "25": 6236,
            "26": 7018,
            "27": 8214,
            "28": 6841,
            "29": 5661,
            "30": 6666
        },
        "5": {
            "1": 6435,
            "2": 5804,
            "3": 5654,
            "4": 5704,
            "5": 6043,
            "6": 5725,
            "7": 5829,
            "8": 6275,
            "9": 5898,
            "10": 6548,
            "11": 6366,
            "12": 6469,
            "13": 5584,
            "14": 5411,
            "15": 5354,
            "16": 6065,
            "17": 6441,
            "18": 6997,
            "19": 6764,
            "20": 5863,
            "21": 5879,
            "22": 6036,
            "23": 5875,
            "24": 6547,
            "25": 7194,
            "26": 6513,
            "27": 6298,
            "28": 6021,
            "29": 6078,
            "30": 5827,
            "31": 6643
        },
        "6": {
            "1": 7038,
            "2": 6826,
            "3": 6060,
            "4": 6051,
            "5": 5933,
            "6": 6222,
            "7": 6299,
            "8": 7130,
            "9": 6870,
            "10": 6462,
            "11": 6551,
            "12": 7323,
            "13": 5920,
            "14": 6170,
            "15": 6815,
            "16": 6990,
            "17": 6275,
            "18": 6249,
            "19": 5995,
            "20": 6292,
            "21": 6719,
            "22": 6973,
            "23": 6764,
            "24": 5788,
            "25": 5788,
            "26": 5462,
            "27": 5354,
            "28": 5831,
            "29": 6656,
            "30": 6844
        },
        "7": {
            "1": 5573,
            "2": 5610,
            "3": 5883,
            "4": 5980,
            "5": 6265,
            "6": 6911,
            "7": 6933,
            "8": 5715,
            "9": 5565,
            "10": 5952,
            "11": 5509,
            "12": 6633,
            "13": 6532,
            "14": 6299,
            "15": 5561,
            "16": 5105,
            "17": 5358,
            "18": 5725,
            "19": 6062,
            "20": 6708,
            "21": 6183,
            "22": 5781,
            "23": 5324,
            "24": 5273,
            "25": 5658,
            "26": 5934,
            "27": 6425,
            "28": 6172,
            "29": 5775,
            "30": 5769,
            "31": 5437
        },
        "8": {
            "1": 5591,
            "2": 6255,
            "3": 6769,
            "4": 6337,
            "5": 5368,
            "6": 5659,
            "7": 5447,
            "8": 5798,
            "9": 5501,
            "10": 6440,
            "11": 6909,
            "12": 5675,
            "13": 5896,
            "14": 5971,
            "15": 5922,
            "16": 6203,
            "17": 6020,
            "18": 6362,
            "19": 5927,
            "20": 5698,
            "21": 6098,
            "22": 5950,
            "23": 6382,
            "24": 6822,
            "25": 6703,
            "26": 6289,
            "27": 5767,
            "28": 6151,
            "29": 6040,
            "30": 6819,
            "31": 7109
        },
        "9": {
            "1": 7405,
            "2": 7239,
            "3": 6261,
            "4": 5937,
            "5": 5889,
            "6": 6292,
            "7": 7005,
            "8": 6816,
            "9": 5599,
            "10": 5847,
            "11": 5615,
            "12": 5621,
            "13": 6209,
            "14": 7190,
            "15": 6956,
            "16": 5557,
            "17": 5185,
            "18": 5339,
            "19": 5692,
            "20": 6465,
            "21": 7479,
            "22": 6910,
            "23": 5331,
            "24": 5208,
            "25": 5288,
            "26": 5620,
            "27": 6352,
            "28": 7171,
            "29": 6561,
            "30": 5422
        },
        "10": {
            "1": 5441,
            "2": 5202,
            "3": 5556,
            "4": 6199,
            "5": 7196,
            "6": 5935,
            "7": 5458,
            "8": 5603,
            "9": 4910,
            "10": 5031,
            "11": 6403,
            "12": 6712,
            "13": 6885,
            "14": 5220,
            "15": 5510,
            "16": 5449,
            "17": 5543,
            "18": 6051,
            "19": 7080,
            "20": 6741,
            "21": 5274,
            "22": 5298,
            "23": 5158,
            "24": 5006,
            "25": 6132,
            "26": 7453,
            "27": 6644,
            "28": 5354,
            "29": 5138,
            "30": 5055,
            "31": 5082
        },
        "11": {
            "1": 6220,
            "2": 7602,
            "3": 6336,
            "4": 6738,
            "5": 4798,
            "6": 4915,
            "7": 5316,
            "8": 6033,
            "9": 7375,
            "10": 6792,
            "11": 5377,
            "12": 5029,
            "13": 5277,
            "14": 5412,
            "15": 5890,
            "16": 7010,
            "17": 6471,
            "18": 5293,
            "19": 5244,
            "20": 5449,
            "21": 5464,
            "22": 5892,
            "23": 7309,
            "24": 6564,
            "25": 5031,
            "26": 5092,
            "27": 5281,
            "28": 5211,
            "29": 6666,
            "30": 7535
        },
        "12": {
            "1": 7308,
            "2": 4787,
            "3": 4853,
            "4": 5095,
            "5": 5131,
            "6": 5684,
            "7": 6928,
            "8": 6390,
            "9": 4939,
            "10": 5012,
            "11": 5294,
            "12": 5114,
            "13": 6287,
            "14": 7374,
            "15": 6826,
            "16": 5099,
            "17": 5434,
            "18": 5458,
            "19": 5737,
            "20": 6545,
            "21": 8346,
            "22": 7844,
            "23": 5907,
            "24": 6250,
            "25": 6541,
            "26": 6975,
            "27": 7249,
            "28": 9501,
            "29": 9837,
            "30": 10981,
            "31": 10864
        }
    }
}