{
    "2020": {
        "1": {
            "1": 4242,
            "2": 6606,
            "3": 6400,
            "4": 6250,
            "5": 6328,
            "6": 6796,
            "7": 6262,
            "8": 5980,
            "9": 4744,
            "10": 5461,
            "11": 6486,
            "12": 5949,
            "13": 4797,
            "14": 5004,
            "15": 4892,
            "16": 4831,
            "17": 5574,
            "18": 6898,
            "19": 6089,
            "20": 4974,
            "21": 4445,
            "22": 4660,
            "23": 4750,
            "24": 5490,
            "25": 6803,
            "26": 6196,
            "27": 4804,
            "28": 4765,
            "29": 4680,
            "30": 4786,
            "31": 5475
        },
        "2": {
            "1": 6834,
            "2": 6169,
            "3": 4580,
            "4": 4583,
            "5": 4740,
            "6": 4456,
            "7": 5130,
            "8": 6698,
            "9": 5652,
            "10": 4726,
            "11": 4507,
            "12": 4847,
            "13": 4980,
            "14": 5946,
            "15": 6694,
            "16": 6090,
            "17": 4818,
            "18": 5087,
            "19": 5135,
            "20": 5448,
            "21": 6384,
            "22": 7871,
            "23": 6523,
            "24": 6311,
            "25": 4747,
            "26": 4463,
            "27": 4622,
            "28": 5811,
            "29": 6901
        },
        "3": {
            "1": 6412,
            "2": 4674,
            "3": 5316,
            "4": 5765,
            "5": 6258,
            "6": 7226,
            "7": 9665,
            "8": 8903,
            "9": 7189,
            "10": 5043,
            "11": 5233,
            "12": 5086,
            "13": 5446,
            "14": 7126,
            "15": 6170,
            "16": 5343,
            "17": 5413,
            "18": 5069,
            "19": 4804,
            "20": 5193,
            "21": 6186,
            "22": 5239,
            "23": 4155,
            "24": 4246,
            "25": 4494,
            "26": 4363,
            "27": 4904,
            "28": 3447,
            "29": 2640,
            "30": 2013,
            "31": 1725
        },
        "4": {
            "1": 1873,
            "2": 2018,
            "3": 2304,
            "4": 2213,
            "5": 2042,
            "6": 2224,
            "7": 2214,
            "8": 2277,
            "9": 2503,
            "10": 2666,
            "11": 2783,
            "12": 2666,
            "13": 2320,
            "14": 2494,
            "15": 2070,
            "16": 2161,
            "17": 2815,
            "18": 2800,
            "19": 1946,
            "20": 2226,
            "21": 2338,
            "22": 2196,
            "23": 2399,
            "24": 2698,
            "25": 2715,
            "26": 2559,
            "27": 2383,
            "28": 2677,
            "29": 2570,
            "30": 3069
        },
        "5": {
            "1": 2783,
            "2": 2575,
            "3": 2623,
            "4": 2412,
            "5": 2447,
            "6": 2427,
            "7": 2572,
            "8": 2944,
            "9": 2551,
            "10": 2543,
            "11": 2739,
            "12": 2524,
            "13": 2670,
            "14": 2597,
            "15": 3109,
            "16": 3187,
            "17": 2789,
            "18": 2514,
            "19": 2624,
            "20": 2668,
            "21": 2698,
            "22": 3183,
            "23": 3307,
            "24": 2847,
            "25": 3088,
            "26": 2983,
            "27": 3124,
            "28": 3183,
            "29": 3071,
            "30": 3641,
            "31": 3067
        },
        "6": {
            "1": 3421,
            "2": 3486,
            "3": 3587,
            "4": 3827,
            "5": 4079,
            "6": 4607,
            "7": 4286,
            "8": 4220,
            "9": 4288,
            "10": 4301,
            "11": 4674,
            "12": 4694,
            "13": 4631,
            "14": 4586,
            "15": 4110,
            "16": 4253,
            "17": 4009,
            "18": 4326,
            "19": 4614,
            "20": 4731,
            "21": 4849,
            "22": 4272,
            "23": 4400,
            "24": 4774,
            "25": 4970,
            "26": 5543,
            "27": 5715,
            "28": 5532,
            "29": 4894,
            "30": 5198
        },
        "7": {
            "1": 6131,
            "2": 4752,
            "3": 5366,
            "4": 5842,
            "5": 5410,
            "6": 4765,
            "7": 4438,
            "8": 4423,
            "9": 4565,
            "10": 5180,
            "11": 5051,
            "12": 4413,
            "13": 3470,
            "14": 3090,
            "15": 3310,
            "16": 3310,
            "17": 3349,
            "18": 3660,
            "19": 3514,
            "20": 2745,
            "21": 2749,
            "22": 2746,
            "23": 2877,
            "24": 3108,
            "25": 3398,
            "26": 3265,
            "27": 2546,
            "28": 2625,
            "29": 2710,
            "30": 2820,
            "31": 2935
        },
        "8": {
            "1": 3226,
            "2": 3166,
            "3": 2830,
            "4": 2802,
            "5": 2537,
            "6": 2587,
            "7": 2604,
            "8": 3081,
            "9": 2823,
            "10": 2579,
            "11": 2833,
            "12": 2640,
            "13": 2787,
            "14": 2866,
            "15": 3333,
            "16": 3161,
            "17": 2610,
            "18": 2542,
            "19": 2660,
            "20": 2548,
            "21": 2675,
            "22": 3021,
            "23": 3138,
            "24": 2570,
            "25": 2769,
            "26": 2633,
            "27": 2997,
            "28": 3037,
            "29": 4123,
            "30": 4165,
            "31": 4102
        },
        "9": {
            "1": 3519,
            "2": 2915,
            "3": 2762,
            "4": 2548,
            "5": 3200,
            "6": 3522,
            "7": 2488,
            "8": 2234,
            "9": 2556,
            "10": 2388,
            "11": 2911,
            "12": 3743,
            "13": 3433,
            "14": 2462,
            "15": 2485,
            "16": 2719,
            "17": 2073,
            "18": 2709,
            "19": 3656,
            "20": 3583,
            "21": 2297,
            "22": 2430,
            "23": 2524,
            "24": 2479,
            "25": 2605,
            "26": 3066,
            "27": 3185,
            "28": 2033,
            "29": 2304,
            "30": 2605
        },
        "10": {
            "1": 2454,
            "2": 2469,
            "3": 2954,
            "4": 2998,
            "5": 2175,
            "6": 2295,
            "7": 2152,
            "8": 2256,
            "9": 2305,
            "10": 3234,
            "11": 3248,
            "12": 2276,
            "13": 2293,
            "14": 2395,
            "15": 2268,
            "16": 2164,
            "17": 3205,
            "18": 2930,
            "19": 2358,
            "20": 2243,
            "21": 2446,
            "22": 2047,
            "23": 2176,
            "24": 3019,
            "25": 3162,
            "26": 2009,
            "27": 1956,
            "28": 2143,
            "29": 2300,
            "30": 2349,
            "31": 3063
        },
        "11": {
            "1": 2911,
            "2": 2078,
            "3": 2141,
            "4": 3043,
            "5": 2100,
            "6": 2308,
            "7": 2983,
            "8": 2548,
            "9": 1979,
            "10": 2263,
            "11": 502,
            "12": 2282,
            "13": 2420,
            "14": 3251,
            "15": 2920,
            "16": 2046,
            "17": 2355,
            "18": 2366,
            "19": 1866,
            "20": 2200,
            "21": 3136,
            "22": 2890,
            "23": 1950,
            "24": 2106,
            "25": 2189,
            "26": 2437,
            "27": 2685,
            "28": 3317,
            "29": 3291,
            "30": 2244
        },
        "12": {
            "1": 2198,
            "2": 1211,
            "3": 2295,
            "4": 2383,
            "5": 3105,
            "6": 3021,
            "7": 2131,
            "8": 2228,
            "9": 2262,
            "10": 2437,
            "11": 2786,
            "12": 3536,
            "13": 3249,
            "14": 2248,
            "15": 2716,
            "16": 2792,
            "17": 3049,
            "18": 8011
        }
    }
}